 O  *  X  *  X  X  X  X  *  X 
 O  X  X  X  X  *  X  *  X  X 
 O  *  X  *  X  X  X  X  X  * 
 O  X  X  X  X  *  X  *  X  X 
 O  *  X  *  *  X  X  X  *  X 
 O  O  X  X  X  *  X  *  *  X 
 *  O  *  *  X  *  X  *  X  X 
 X  O  *  X  X  X  X  X  X  * 
 *  O  O  *  X  *  *  X  *  X 
 *  *  O  O  O  O  O  O  O  O 
